555555555555555555555555555555555555555
555555555555555555555555555555555555555
555000555555555555555555555555555000555
555000555000555555000555555000555000555
555000555000555555000555555000555000555
555000555000555000000000555000555000555
555000555000555000000000555000555000555
555000555000555555000555555000555000555
555555555000555555000555555000555555555
555555555555555555000555555555555555555
555555555555555555000555555555555555555
555000000000555555555555555000000000555
555000000000555555555555555000000000555
555555555555555555000555555555555555555
555555555555555555000555555555555555555
555555555000555555000555000000555555555
555555555000555555000555000000555555555
111111555555555555111555555555555111111
111111555555555555111555555555555111111
555555555000000555000555555000555555555
555555555000000555000555555000555555555
555555555555555555000555555555555555555
555555555555555555000555555555555555555
555000000000555555555555555000000000555
555000000000555555555555555000000000555
555555555555555555000555555555555555555
555555555555555555000555555555555555555
555555555000555555000555555000555555555
555000555000555555000555555000555000555
555000555000555000000000555000555000555
555000555000555000000000555000555000555
555000555000555555555555555000555000555
555000555000555555555555555000555000555
555000555555555500000005555555555000555
555555555555555500555005555555555555555
555555555555555500555005555555555555555