222222222222222222222222222222222222222
222222222222222222222222222222222222222
222000222222222222222222222222222000222
222000222000222222000222222000222000222
222000222000222222000222222000222000222
222000222000222000000000222000222000222
222000222000222000000000222000222000222
222000222000222222000222222000222000222
222222222000222222000222222000222222222
222222222222222222000222222222222222222
222222222222222222000222222222222222222
222000000000222222222222222000000000222
222000000000222222222222222000000000222
222222222222222222000222222222222222222
222222222222222222000222222222222222222
222222222000222222000222000000222222222
222222222000222222000222000000222222222
111111222222222222111222222222222111111
111111222222222222111222222222222111111
222222222000000222000222222000222222222
222222222000000222000222222000222222222
222222222222222222000222222222222222222
222222222222222222000222222222222222222
222000000000222222222222222000000000222
222000000000222222222222222000000000222
222222222222222222000222222222222222222
222222222222222222000222222222222222222
222222222000222222000222222000222222222
222000222000222222000222222000222000222
222000222000222000000000222000222000222
222000222000222000000000222000222000222
222000222000222222222222222000222000222
222000222000222222222222222000222000222
222000222222222200000002222222222000222
222222222222222200222002222222222222222
222222222222222200222002222222222222222